SO   pics_xpm/greystone.xpm
NO    pics_xpm/colorstone.xpm
WE     pics_xpm/redbrick.xpm
EA      pics_xpm/mossy.xpm

F 102,178 ,255
C 12,25 ,255

        111111111111111111111111111111111111111111111111111111111111111
10000000000000000000000000001100000010011000000000000000000000000000110000001001
10000000000000000000000000001100000010011000000000000000000000000000110000001001
10000000000000000000000000001100000010011000000000000000000000000000110000001001
10000000000000000000000000001100000010011000000000000000000000000000110000001001
10000000000000000000000000001100000010011000000000000000000000000000110000001001
10000000000000000000000000001100000010011000000000000000000000000000110000001001
10000000000000000000000000001100000010011000000000000000000000000000110000001001
10000000000000000000000000001100000010011000000000000000000000000000110000001001
10000000000000000000000000001100000010011000000000000000000000000000110000001001
10000000000000000000000000001100000010011000000000000000000000000000110000001001
10000000000000000000000000001100000010011000000000000000000000000000110000001001
10000000000000000000000000001100000010011000000000000000000000000000110000001001
10000000000000000000000000001100000010011000000000000000000000000000110000001001
10000000000000 000000000000001100000010011000000000000000000000000000110000001001
100000000000001000000000 1100 000000000011000000000000000000000000000110000001001
        10110000011100000000000011000000000000000000000000000110000001001
        10010000000000000000000011000000000000000000000000000110000001001
1111111110110000011100000000000011000000000000000000000000000110000001001
1000000000110000 01110111111111111000000000000000000000000000110000001001
111101111111110111 0000 00100011000000000000000000000000000110000001001
111101111111110111010100100011000000000000000000000000000110000001001
110000001101010111000000100011000000000000000000000000000110000001001
10000000000000001100000010011000000000000000000000000000110000001001
10000000000000011010100100011000000000000000000000000000110000001001
11000001E1010101111101111000111000000000000000000000000000110000001001
11110111 1110101 10111101000111000000000000000000000000000110000001001
1111111111111 1111111111111111111111111111111111111111111111111111111