EA      pics_xpm/bluestone.xpm
SO   pics_xpm/eagle.xpm
WE     pics_xpm/greystone.xpm
NO             pics_xpm/tex_or_stone.xpm
F 102,178 ,255
C 12,25 ,255
111111111111111111
1000000000000000001
10S0000000000000001
1111111111111111111