SO   pics_xpm/eagle.xpm
NO    pics_xpm/redbrick.xpm
WE     pics_xpm/greystone.xpm
EA      pics_xpm/bluestone.xpm

F 102,178 ,255
C 12,25 ,255

        111111111111111111111
        1000000000 1100 00000000001
        1011000001110000000000001
        1001000000000000000000001
111111111011000001110000000000001
1000000000110000 0111011111111111
111101111111110111 0000 0010001
11110111111111011101010010001
11000000110101011100000010001
1000000000000000110000001001
1000000000000001101010010001
11000001E101010111110111100011
11110111 1110101 1011110100011
1111111111111 111111111111