SO      pics_xpm/eagle.xpm
NO      pics_xpm/redbrick.xpm
WE    pics_xpm/greystone.xpm
EA      pics_xpm/tex_multi.xpm



F 0,0,0
C 76,174,227

        1111111111111111111111111
        1000000000110000000000001
        1011000001110000000000001
        1001000000000000000000001
111111111011000001110000000000001
100000000011000001110111111111111
11110111111111011100000010001
11000000110101011100000010001
100000S0000000001100000010001
1000000000000001101010010001
110000011101010111110111100111
11110111 1110101 101111010001
11111111 1111111 111111111111