EA      pics_xpm/bluestone.xpm
SO   pics_xpm/eagle.xpm
WE     pics_xpm/greystone.xpm
NO             pics_xpm/tex_or_stone.xpm
F 0,0,0
C 76,174,227
1111111111111111111111111111
10000000000000000010000000000000100000001000000010000000100000001000000010000000100000001000000000001
10S00000000000000000000000000010000000100000001000000010000000100000001000000010000000100000001000001
1111111111111111111111111111111